00000000000000000000000000000000000000000000000000
00000000000000000000000000000000000000000000000000
00000000000000000000000000001111111110111111000000
00000000000000000000000000001000000011100001000000
00000000000000000000000000001000000000000001000000
00000000000000000000000000001000000000000001000000
00000000000000000000000000001000000000000001000000
00000000000000000000000000001000000011100001000000
00000000000000000000000000001110001110111111000000
00000000000000000000000000000010001000000000000000
00000000000000000000000000000010001000000000000000
00000000000000000000000000000010001000000000000000
00000000000000000000000000000010001000000000000000
00000000000000000000000000000010001000000000000000
00000000000000000000000000000010001000000000000000
00000000000000000000000001111110001111000000000000
00000000000000000000000001000000000001011111111100
00111111111111111111111111000000000001110000000100
00100000000000000000000000000000000000000000000100
00100000000000000000000000000000000000000000000100
00100000000000000000000000000000000000000000000100
00100011111111111111111111000000000001110000000100
00100010000000000000000001000000000001011100000100
00100010000000000000000001111000111111000100000100
00100010000000000000000000001000100000000100000100
00100011111111101111111111101000101111110100000100
00100000000000111000000000101000111000010100000100
00100000000000000000000000101000000000010100000100
00100000000000000000000000101000000000010110001100
00100000000000000000000000101000000000010010001000
00100000000000111000000000101000111000010010001000
00100000000000101111111111101000101111110010001000
00100000000000100000000000001000100000000010001000
00100000000000101111111111111000111111111110001000
00100000000000101000000000000000000000000000001000
00100000000000101000000000000000000000000000001000
00100000000000101000000000000000000000000000001000
00100000000000101000111110000000000011111100011000
00100000000000101000100010000000000010000100010000
00100000000000101000100010000000000010001100011000
00111000111111101000100011111111111110001000001000
00001000100000001000100000000000000000001000001000
00001000100011111000111111111110000000001000001000
00001000100010000000000000000011111111111000001000
00001000100010000000000000000011000000011000001000
00001000111110000000000000000011000000011000001000
00001000000000000000000000000000000000011000001000
00001000000000000000000000000000000000011000001000
00001000000000000000000000000000000000011000001000
00001000111110000000000000000011000000011111111000
00001000100010000000000000000011000000010000000000
00001000100010000000000000000011111111110000000000
00011000110011111111111111111110000000000000000000
00010000010000000000000000000000000000000000000000
00010000010000000000000000000000000000000000000000
00010000010000000000000000000000000000000000000000
00010000010000000000000000000000000000000000000000
00011111110000000000000000000000000000000000000000
00000000000000000000000000000000000000000000000000
00000000000000000000000000000000000000000000000000