000000000000000000000000000000000000000000000000000000000
000000000000000000000000000000000000000000000000000000000
000000000000000000000000000000000001111111110111111100000
000000000000000000000000000000000001111011111111001100000
000000000000000000000000000000000001110001100000000100000
000000000000000000000000000000000001000000000000000100000
000000000000000000000000000000000001000000000000000100000
000000000000000000000000000000000001000000011100001100000
000000000000000000000000000000000001110001110111111100000
000000000000000000000000000000000000010001000000000000000
000000000000000000000000000000000000010001000000000000000
000000000000000000000000000000000000010001000000000000000
000000000000000000000000000000000000010011000000000000000
000000000000000000000000000000000000010001000000000000000
000000000000000000000000000000000000010001000000000000000
000000000000000000000000000000001111110001111000000000000
000000000000000000000000000000001111110001111011111111100
000000001111111111111111111111111101000001011110000000100
000000001100000000000000000000000000000000000000000000100
000000001000000000000000000000000000000000000000000000100
000000001000000000000000000000000000000000000000000001100
000000001000111111111111111111111000000000001110000001100
000000001000100000000000000000001000000001111011100000100
000000001000100000000000000000001111000111111000110001100
000000001000100000000000000000000001000100000000110001100
000000001000111111111110111111111111000101111111100000100
000000001222111112222211111111110011000111100111110001100
000000001222211112222200000000000011000000000001110001100
000000001222222222222200000000000011000000000001110001100
000000001222222222222200000000000011000000000001010001000
000000001111222222211111111111100111000111110001010001000
000000001111221112211111111111111101000101111111010001000
000000001111221112211110000000000001000100000000010001000
000000001111222222211111111111111111000111111111110001000
000000001111222222211111000000000011000110000100000001000
000000001111222222211111000000000010000100000000000001000
000000001111221112211111000000000000000000000000000001000
000000001111221112211111000111110000000000011111100011000
000000001111222222211111000100010000000000010000100010000
000000001222222222222211001100010110001100010001100011000
000000001111000111111111000100011111111111110001000011000
000000000001000100000001000100000000000000000001000011000
000000000001000100011111000111111111110000000001000011000
000000000001000100010000000000000000111111111111000001000
000000000001000100010111000111000111011111110011000001000
000000000001000111110111000111000111011000000011000001000
000000000001000000000000000000000000000000000011100001000
000000000001000000000000000000000000000000000111111001000
000000000001000000000111000111000111000000000011111111000
000000000001100111110111000111000111011000000010000000000
000000000001000100010000000000000000011111110010000000000
000000000000000001000100010000000000000000011111111110000
000000000111000111011111111111111111110000000000000000000
000000000111000001000000000000000000000000000000000000000
000000000100000001000000000000000000000000000000000000000
000000000100000001000000000000000000000000000000000000000
000000000111111111000000000000000000000000000000000000000
000000000111111111000000000000000000000000000000000000000
000000000000000000000000000000000000000000000000000000000
000000000000000000000000000000000000000000000000000000000